1 1 1 1 1 1 1 1 1 1 1 1 1
3 4 5 4 5 4 5 4 5 4 5 4 5
8 14 9 14 9 14 9 14 9 14 9 14 9
14 11 12 13 14 14 14 14 14 14 11 13 14
14 14 14 11 12 12 12 12 13 14 14 14 14
14 14 14 14 14 14 14 14 14 14 11 12 12
14 14 14 14 14 14 14 14 14 14 14 14 14
15 15 15 15 15 15 15 15 15 15 15 15 15
16 16 16 16 16 16 16 16 16 16 16 16 16
16 16 16 16 16 16 16 16 16 16 16 16 16
16 16 16 16 16 16 16 16 16 16 16 16 16
16 16 16 16 16 16 16 16 16 16 16 16 16
16 16 16 16 16 16 16 16 16 16 16 16 16
15 15 15 15 15 15 15 15 15 15 15 15 15
