1 1 1 1 1 1 1 1 1 1 1 1 1 1 1 1 1 1 1 1 1
3 4 5 4 5 4 5 4 5 4 5 4 5 4 5 4 5 4 5 4 7
8 14 9 14 9 14 9 14 9 14 9 14 9 14 9 14 9 14 9 14 10
14 11 12 13 14 14 14 14 14 14 11 13 14 14 14 14 14 14 14 14 14
14 11 12 13 14 14 14 14 14 14 11 13 14 14 14 14 14 14 14 14 14
14 14 14 11 12 12 12 12 13 14 14 14 14 14 14 14 14 14 14 14 14
14 14 14 14 14 14 14 14 14 14 11 12 12 12 13 14 14 14 14 14 14
14 14 14 14 14 14 14 14 14 14 14 14 14 14 14 14 14 14 14 14 14
15 15 15 15 15 15 15 15 15 15 15 15 15 15 15 15 15 15 15 15 15
16 16 16 16 16 16 16 16 16 16 16 16 16 16 16 16 16 16 16 16 16
16 17 16 17 16 17 16 17 16 17 16 17 16 17 16 17 16 17 16 17 16
16 18 16 18 16 18 16 18 16 18 16 18 16 18 16 18 16 18 16 18 16
16 17 16 17 16 17 16 17 16 17 16 17 16 17 16 17 16 17 16 17 16
16 18 16 18 16 18 16 18 16 18 16 18 16 18 16 18 16 18 16 18 16
16 16 16 16 16 16 16 16 16 16 16 16 16 16 16 16 16 16 16 16 16
22 22 22 22 22 22 22 22 22 22 22 22 22 22 22 22 22 22 22 22 22 
